10 10
xyzw______
###__#____
#_##__#___
#_###_#___
__^^O_###_
##______##
__##C###__
___#_#***_
___#_#^^^_
___#_#____